##########
#     #  #
#  X  XX #
#  # #   #
#### ###O#
#  #   #O#
# X  X #O#
#  ##O##O#
##O##  #O#
# X  X #O#
#   #  #O#
### ####O#
### #  P #
#  X  XX #
#        #
##########
