############
#OOOO#   ###
#OOOO#     #
##   # X X #
##   ##X#P##
##   #   X##
## # #  XX##
##   XX    #
##  ##     #
############
